.......................................
.......................................
.......................................
.......................................
#######################################
......................................#
......................................#
......................................#
......................................#
......................................#
......................................#
....##############################......
.......................................
.......................................
.......................................
.......................................
.......................................
.......................................
...............#####...................
....................#..................
....................#..................
....................#..................
....................#..................
................ ....#####.............
.......................................
.......................................
.......................................
.......................................
.......................................
.....##############################....
#..........#...........................
#..........#...........................
#..........#...........................
#..........#...........................
#..........#...........................
#......................................
#......................................
#......................................
#......................................
#...###................................