.......................................
.......................................
.......................................
.......................................
#######################################
.......................................
.......................................
.......................................
.......................................
.......................................
.......................................
.......###########################.....
.......................................
.......................................
.......................................
.......................................
.......................................
.......................................
...............#####...................
.......................................
.......................................
.......................................
.......................................
.....................#####.............
.......................................
.......................................
.......................................
.......................................
.......................................
.......................................
#..........#..........................#
#..........#..........................#
#..........#..........................#
#..........#..........................#
#..........#..........................#
#.....................................#
#.....................................#
#.....................................#
#.....................................#
#######...............................#